1111111111111
1P00000000001
1001000000001
1001000000001
1E01000000001
1111111111111