111111111111111111111111111111111111111111111111111
100000000000000000000000000000000000000000000000001
1000000000P0000000000000000000000000000000000000001
1CCCCCCCCCC00E0000000000000000000000000000000000001
10000011C110000000000000000000000000000000000000001
100000011100000000000000000000000000000000000000001
111111111111111111111111111111111111111111111111111