1111111
100C001
10E0P01
100C001
1111111