111111111111111
100000000000001
100000000000001
100E0000000P001
1000C00000C0001
10000CCCCC00001
100000000000001
111111111111111