1111111
100C001
10E0P01
1111111