1111111
100C001
1100P01
1E1C001
1111111