1111111111111111111111111111111111
1E0000000001000C00000C000000000001
1110010100100000101001000000010101
1010010010101010001001000000010101
100100000C01C000000000000000000PC1
1111111111111111111111111111111111